20,20
00000100000000000000
000S0100000000000000
01001110000000000000
00001100000000000000
0111E000000000000000
01111000000000000000
00100001000100000000
00000000000100000000
01001110000100000000
00001100000100000000
01110000000100000000
01111000011000E00000
00101111100000000000
01110000000000000000
01001110000000000000
00001100000000000000
01110000000000E00000
01111000000000000000
00101111000000000000
01110000000000000100
